 ####                                #
 #   #                               #
 #  #                                #
 ###    # #   ## #  #     #   ###    #
 #  #   ##   #  ##   #   #   #   #
 #   #  #    #  ##    # #    #   #
 ####   #     ## #     #      ###    #

Level bestanden!